Femmes Gourmantché dans leur potager - Julie Bousquet
Hécatombe - David Combaz
Vachement solidaire ! - L'Alchineuse
Corp(s) - Abigail Cuenca
Une autre voie est possible - Matthieu Liaigre
Obrigada senhor - Colette Riehl
Collé gramme - Pascal Nitkowski
Où est Charlie ? - David Combaz
Sans titre (Ethiopie) - Marie-Astrid Gouigou
Environnement de l'abattoir - Joachim Lefaure
La fourche dorée - Julien Robert
Face à face - Luc Maréchaux
Ratatam - Pascal Nitkowski
Yann et Armelle - Jean-Christophe Denis
Correcteur d'assiette - Phillipe Lelièvre
Fourchette - Nicolas de Neve
L'enclos - Mickaël Correia
Mineria responsable - Émeline Afriat
En famille - Marc Larrigue
Truite au colza - Cédric Lemarchand
Fourche nourissante - Sylvain Fabbri
Labours - Amélie Dalibert
Découper - Virgine Plauchut
Cochon prenant du plaisir avec des enfants - Gilles Emsalem
Bidons de lait - Nathalie Perrot
Programmé pour s'autodétruire - Galith Sultran
Roule ta botte - Marie-Laure Escafre
Œufs frais - Émilie Gentils
Cagettes - Mickaël Correia
Persil-neige - Pierre Bignolas
J'aime mes salades - Alain Pellorce
Du champ à l'assiette, partageons la route - Ruppert Vimal
Blés bien rangés - Émilie Gentils
Sans titre - vincent Kayser Milleliri
Plants de salade - Émilie Duplan
Petit déjeuner - Leticia Delboy
Deuxpetits cochons - Nathalie Perrot
Pantagruel au supermarché - Philippe Lelièvre
Ola52503 Weiss blanc européen - Véronique Ambert
Fourchées paradoxales - Benjamin Ancel
A table ! Après la fourchette - Mael Garrin
Plantation à la main d'un jeune plan de roïbos - Claire Ruols
Combien faut-il de litres pour quelques centilitres ? - Aurélien Trioux
Poules - Jean-Christophe Denis
